0x2514ABF8, 37404069177046944, 88891469, 88891486, 17, 1920x1080 
0x2514ABF8, 37404069177534024, 88891517, 88891532, 15, 1920x1080 
0x2514ABF8, 37404069178053704, 88891560, 88891574, 14, 1920x1080 
0x2514ABF8, 37404069178913776, 88891674, 88891712, 38, 640x360 
0x2514ABF8, 37404069179340376, 88891712, 88891716, 4, 640x360 
0x2514ABF8, 37404069179774240, 88891741, 88891745, 4, 640x360 
0x2514ABF8, 37404069180226480, 88891791, 88891800, 9, 640x360 
0x2514ABF8, 37404069180688752, 88891829, 88891832, 3, 640x360 
0x2514ABF8, 37404069181105232, 88891869, 88891882, 13, 640x360 
0x2514ABF8, 37404069181512704, 88891906, 88891910, 4, 640x360 
0x2514ABF8, 37404069181894640, 88891953, 88891962, 9, 640x360 
0x2514ABF8, 37404069182334480, 88891992, 88891994, 2, 640x360 
0x2514ABF8, 37404069182722384, 88892036, 88892045, 9, 640x360 
0x2514ABF8, 37404069183158952, 88892074, 88892077, 3, 640x360 
0x2514ABF8, 37404069183540312, 88892118, 88892129, 11, 640x360 
0x2514ABF8, 37404069184002696, 88892157, 88892161, 4, 640x360 
0x2514ABF8, 37404069184396880, 88892202, 88892212, 10, 640x360 
0x2514ABF8, 37404069184831328, 88892241, 88892244, 3, 640x360 
0x2514ABF8, 37404069185222672, 88892287, 88892296, 9, 640x360 
0x2514ABF8, 37404069185668664, 88892320, 88892326, 6, 640x360 
0x2514ABF8, 37404069186048384, 88892366, 88892378, 12, 640x360 
0x2514ABF8, 37404069186500376, 88892404, 88892407, 3, 640x360 
0x2514ABF8, 37404069186872720, 88892450, 88892461, 11, 640x360 
0x2514ABF8, 37404069187325704, 88892488, 88892492, 4, 640x360 
0x2514ABF8, 37404069187717784, 88892534, 88892545, 11, 640x360 
0x2514ABF8, 37404069188154792, 88892574, 88892577, 3, 640x360 
0x2514ABF8, 37404069188544928, 88892618, 88892628, 10, 640x360 
0x2514ABF8, 37404069188991440, 88892656, 88892660, 4, 640x360 
0x2514ABF8, 37404069189378040, 88892702, 88892711, 9, 640x360 
0x2514ABF8, 37404069189836456, 88892737, 88892748, 11, 640x360 
0x2514ABF8, 37404069190192152, 88892771, 88892776, 5, 640x360 
0x2514ABF8, 37404069190994304, 88892849, 88892864, 15, 1920x1080 
0x2514ABF8, 37404069191373376, 88892897, 88892919, 22, 1920x1080 
0x2514ABF8, 37404069191833456, 88892930, 88892943, 13, 1920x1080 
0x2514ABF8, 37404069192194688, 88892974, 88892988, 14, 1920x1080 
0x2514ABF8, 37404069192662544, 88893020, 88893035, 15, 1920x1080 
0x2514ABF8, 37404069193064624, 88893060, 88893074, 14, 1920x1080 
0x2514ABF8, 37404069193517288, 88893099, 88893115, 16, 1920x1080 
0x2514ABF8, 37404069193884808, 88893144, 88893167, 23, 1920x1080 
0x2514ABF8, 37404069194341264, 88893179, 88893192, 13, 1920x1080 
0x2514ABF8, 37404069194700648, 88893224, 88893238, 14, 1920x1080 
0x2514ABF8, 37404069195160112, 88893264, 88893280, 16, 1920x1080 
0x2514ABF8, 37404069195537792, 88893308, 88893322, 14, 1920x1080 
0x2514ABF8, 37404069195996888, 88893353, 88893368, 15, 1920x1080 
0x2514ABF8, 37404069196406352, 88893398, 88893420, 22, 1920x1080 
0x2514ABF8, 37404069196844992, 88893430, 88893443, 13, 1920x1080 
0x2514ABF8, 37404069197210144, 88893475, 88893489, 14, 1920x1080 
0x2514ABF8, 37404069197655272, 88893519, 88893534, 15, 1920x1080 
0x2514ABF8, 37404069198060200, 88893558, 88893573, 15, 1920x1080 
0x2514ABF8, 37404069198502760, 88893603, 88893618, 15, 1920x1080 
0x2514ABF8, 37404069198910480, 88893648, 88893671, 23, 1920x1080 
0x2514ABF8, 37404069199345208, 88893681, 88893695, 14, 1920x1080 
0x2514ABF8, 37404069199711408, 88893725, 88893740, 15, 1920x1080 
0x2514ABF8, 37404069200164672, 88893763, 88893776, 13, 1920x1080 
0x2514ABF8, 37404069200551248, 88893813, 88893837, 24, 1920x1080 
0x2514ABF8, 37404069201006592, 88893851, 88893863, 12, 1920x1080 
0x2514ABF8, 37404069201420176, 88893896, 88893914, 18, 1920x1080 
0x2514ABF8, 37404069201833176, 88893928, 88893952, 24, 1920x1080 
0x2514ABF8, 37404069202178232, 88893966, 88893980, 14, 1920x1080 
0x2514ABF8, 37404069202562544, 88894012, 88894034, 22, 1920x1080 
0x2514ABF8, 37404069202997528, 88894050, 88894067, 17, 1920x1080 
0x2514ABF8, 37404069203389192, 88894096, 88894117, 21, 1920x1080 
0x2514ABF8, 37404069203837680, 88894136, 88894151, 15, 1920x1080 
0x2514ABF8, 37404069204228520, 88894180, 88894199, 19, 1920x1080 
0x2514ABF8, 37404069204679024, 88894212, 88894227, 15, 1920x1080 
0x2514ABF8, 37404069205037344, 88894257, 88894272, 15, 1920x1080 
0x2514ABF8, 37404069205496560, 88894296, 88894310, 14, 1920x1080 
0x2514ABF8, 37404069205878128, 88894341, 88894358, 17, 1920x1080 
0x2514ABF8, 37404069206319824, 88894380, 88894393, 13, 1920x1080 
0x2514ABF8, 37404069206718552, 88894424, 88894438, 14, 1920x1080 
0x2514ABF8, 37404069207157712, 88894468, 88894484, 16, 1920x1080 
0x2514ABF8, 37404069207557984, 88894514, 88894535, 21, 1920x1080 
0x2514ABF8, 37404069208012816, 88894548, 88894564, 16, 1920x1080 
0x2514ABF8, 37404069208364128, 88894594, 88894616, 22, 1920x1080 
0x2514ABF8, 37404069208828216, 88894632, 88894649, 17, 1920x1080 
0x2514ABF8, 37404069209214096, 88894679, 88894700, 21, 1920x1080 
0x2514ABF8, 37404069209663848, 88894713, 88894727, 14, 1920x1080 
0x2514ABF8, 37404069210029608, 88894759, 88894772, 13, 1920x1080 
0x2514ABF8, 37404069210493336, 88894798, 88894812, 14, 1920x1080 
0x2514ABF8, 37404069210891696, 88894847, 88894868, 21, 1920x1080 
0x2514ABF8, 37404069211324760, 88894883, 88894899, 16, 1920x1080 
0x2514ABF8, 37404069211728264, 88894928, 88894950, 22, 1920x1080 
0x2514ABF8, 37404069212167464, 88894966, 88894981, 15, 1920x1080 
0x2514ABF8, 37404069212535464, 88895010, 88895032, 22, 1920x1080 
0x2514ABF8, 37404069212996264, 88895048, 88895065, 17, 1920x1080 
0x2514ABF8, 37404069213364392, 88895093, 88895116, 23, 1920x1080 
0x2514ABF8, 37404069213826504, 88895132, 88895149, 17, 1920x1080 
0x2514ABF8, 37404069214215040, 88895177, 88895199, 22, 1920x1080 
0x2514ABF8, 37404069214668056, 88895215, 88895230, 15, 1920x1080 
0x2514ABF8, 37404069215030728, 88895261, 88895283, 22, 1920x1080 
0x2514ABF8, 37404069215492872, 88895298, 88895312, 14, 1920x1080 
0x2514ABF8, 37404069215883600, 88895341, 88895354, 13, 1920x1080 
0x2514ABF8, 37404069216331848, 88895386, 88895402, 16, 1920x1080 
0x2514ABF8, 37404069216731424, 88895430, 88895450, 20, 1920x1080 
0x2514ABF8, 37404069217184312, 88895462, 88895476, 14, 1920x1080 
0x2514ABF8, 37404069217538960, 88895512, 88895533, 21, 1920x1080 
0x2514ABF8, 37404069217999024, 88895551, 88895567, 16, 1920x1080 
0x2514ABF8, 37404069218391984, 88895594, 88895617, 23, 1920x1080 
0x2514ABF8, 37404069218838800, 88895632, 88895648, 16, 1920x1080 
0x2514ABF8, 37404069219211096, 88895677, 88895700, 23, 1920x1080 
0x2514ABF8, 37404069219666008, 88895715, 88895731, 16, 1920x1080 
0x2514ABF8, 37404069220036048, 88895760, 88895783, 23, 1920x1080 
0x2514ABF8, 37404069220504744, 88895797, 88895811, 14, 1920x1080 
0x2514ABF8, 37404069220866440, 88895847, 88895865, 18, 1920x1080 
0x2514ABF8, 37404069221350920, 88895881, 88895895, 14, 1920x1080 
0x2514ABF8, 37404069221713792, 88895927, 88895951, 24, 1920x1080 
0x2514ABF8, 37404069222173392, 88895965, 88895979, 14, 1920x1080 
0x2514ABF8, 37404069222558936, 88896014, 88896034, 20, 1920x1080 
0x2514ABF8, 37404069223008240, 88896048, 88896062, 14, 1920x1080 
0x2514ABF8, 37404069223398672, 88896098, 88896118, 20, 1920x1080 
0x2514ABF8, 37404069223850904, 88896137, 88896153, 16, 1920x1080 
0x2514ABF8, 37404069224241984, 88896181, 88896194, 13, 1920x1080 
0x2514ABF8, 37404069224705416, 88896232, 88896254, 22, 1920x1080 
0x2514ABF8, 37404069225183656, 88896267, 88896281, 14, 1920x1080 
0x2514ABF8, 37404069225566952, 88896312, 88896336, 24, 1920x1080 
0x2514ABF8, 37404069226017896, 88896350, 88896363, 13, 1920x1080 
0x2514ABF8, 37404069226406776, 88896390, 88896404, 14, 1920x1080 
0x2514ABF8, 37404069226830840, 88896428, 88896442, 14, 1920x1080 
0x2514ABF8, 37404069227204184, 88896479, 88896502, 23, 1920x1080 
0x2514ABF8, 37404069227662880, 88896521, 88896536, 15, 1920x1080 
0x2514ABF8, 37404069228084512, 88896561, 88896575, 14, 1920x1080 
0x2514ABF8, 37404069228522320, 88896600, 88896615, 15, 1920x1080 
0x2514ABF8, 37404069228920360, 88896645, 88896659, 14, 1920x1080 
0x2514ABF8, 37404069229387816, 88896696, 88896714, 18, 1920x1080 
0x2514ABF8, 37404069229847648, 88896730, 88896744, 14, 1920x1080 
0x2514ABF8, 37404069230212328, 88896780, 88896802, 22, 1920x1080 
0x2514ABF8, 37404069230678288, 88896818, 88896832, 14, 1920x1080 
0x2514ABF8, 37404069231097544, 88896863, 88896877, 14, 1920x1080 
0x2514ABF8, 37404069231542328, 88896914, 88896928, 14, 1920x1080 
0x2514ABF8, 37404069232044496, 88896965, 88896981, 16, 1920x1080 
0x2514ABF8, 37404069232538600, 88897015, 88897029, 14, 1920x1080 
0x2514ABF8, 37404069233042200, 88897065, 88897081, 16, 1920x1080 
0x2514ABF8, 37404069233521912, 88897114, 88897132, 18, 1920x1080 
0x2514ABF8, 37404069234009504, 88897149, 88897162, 13, 1920x1080 
0x2514ABF8, 37404069234393400, 88897193, 88897206, 13, 1920x1080 
0x2514ABF8, 37404069234840464, 88897231, 88897243, 12, 1920x1080 
0x2514ABF8, 37404069235216712, 88897276, 88897292, 16, 1920x1080 
0x2514ABF8, 37404069235712744, 88897331, 88897346, 15, 1920x1080 
0x2514ABF8, 37404069236190232, 88897382, 88897398, 16, 1920x1080 
0x2514ABF8, 37404069236695480, 88897431, 88897448, 17, 1920x1080 
0x2514ABF8, 37404069237178008, 88897463, 88897478, 15, 1920x1080 
0x2514ABF8, 37404069237548024, 88897516, 88897537, 21, 1920x1080 
0x2514ABF8, 37404069238007768, 88897551, 88897567, 16, 1920x1080 
0x2514ABF8, 37404069238386464, 88897595, 88897609, 14, 1920x1080 
0x2514ABF8, 37404069238846368, 88897639, 88897655, 16, 1920x1080 
0x2514ABF8, 37404069239264160, 88897678, 88897691, 13, 1920x1080 
0x2514ABF8, 37404069239700608, 88897729, 88897751, 22, 1920x1080 
0x2514ABF8, 37404069240168704, 88897767, 88897782, 15, 1920x1080 
0x2514ABF8, 37404069240547360, 88897812, 88897832, 20, 1920x1080 
0x2514ABF8, 37404069241011000, 88897846, 88897859, 13, 1920x1080 
0x2514ABF8, 37404069241375832, 88897895, 88897915, 20, 1920x1080 
0x2514ABF8, 37404069241847640, 88897931, 88897944, 13, 1920x1080 
0x2514ABF8, 37404069242211544, 88897975, 88897990, 15, 1920x1080 
0x2514ABF8, 37404069242659456, 88898014, 88898027, 13, 1920x1080 
0x2514ABF8, 37404069243109248, 88898063, 88898084, 21, 1920x1080 
0x2514ABF8, 37404069243511136, 88898097, 88898110, 13, 1920x1080 
0x2514ABF8, 37404069243884240, 88898142, 88898156, 14, 1920x1080 
0x2514ABF8, 37404069244332248, 88898181, 88898194, 13, 1920x1080 
0x2514ABF8, 37404069244710472, 88898226, 88898240, 14, 1920x1080 
0x2514ABF8, 37404069245173248, 88898267, 88898283, 16, 1920x1080 
0x2514ABF8, 37404069245548984, 88898310, 88898324, 14, 1920x1080 
0x2514ABF8, 37404069246013856, 88898353, 88898369, 16, 1920x1080 
0x2514ABF8, 37404069246437536, 88898397, 88898417, 20, 1920x1080 
0x2514ABF8, 37404069246847312, 88898430, 88898443, 13, 1920x1080 
0x2514ABF8, 37404069247218032, 88898479, 88898501, 22, 1920x1080 
0x2514ABF8, 37404069247682472, 88898513, 88898526, 13, 1920x1080 
0x2514ABF8, 37404069248040896, 88898557, 88898571, 14, 1920x1080 
0x2514ABF8, 37404069248482728, 88898596, 88898608, 12, 1920x1080 
0x2514ABF8, 37404069248878624, 88898641, 88898655, 14, 1920x1080 
0x2514ABF8, 37404069249315256, 88898686, 88898700, 14, 1920x1080 
0x2514ABF8, 37404069249719216, 88898726, 88898741, 15, 1920x1080 
0x2514ABF8, 37404069250166336, 88898765, 88898778, 13, 1920x1080 
0x2514ABF8, 37404069250559040, 88898809, 88898823, 14, 1920x1080 
0x2514ABF8, 37404069250990984, 88898849, 88898864, 15, 1920x1080 
0x2514ABF8, 37404069251374432, 88898893, 88898908, 15, 1920x1080 
0x2514ABF8, 37404069251821192, 88898932, 88898944, 12, 1920x1080 
0x2514ABF8, 37404069252226408, 88898976, 88899001, 25, 1920x1080 
0x2514ABF8, 37404069252653992, 88899015, 88899028, 13, 1920x1080 
0x2514ABF8, 37404069253056792, 88899058, 88899073, 15, 1920x1080 
0x2514ABF8, 37404069253497600, 88899097, 88899111, 14, 1920x1080 
0x2514ABF8, 37404069253868184, 88899145, 88899168, 23, 1920x1080 
0x2514ABF8, 37404069254343376, 88899184, 88899200, 16, 1920x1080 
0x2514ABF8, 37404069254717888, 88899229, 88899251, 22, 1920x1080 
0x2514ABF8, 37404069255174944, 88899268, 88899283, 15, 1920x1080 
0x2514ABF8, 37404069255545088, 88899312, 88899333, 21, 1920x1080 
0x2514ABF8, 37404069256002464, 88899346, 88899358, 12, 1920x1080 
0x2514ABF8, 37404069256367680, 88899396, 88899416, 20, 1920x1080 
0x2514ABF8, 37404069256834552, 88899429, 88899442, 13, 1920x1080 
0x2514ABF8, 37404069257191608, 88899479, 88899501, 22, 1920x1080 
0x2514ABF8, 37404069257670632, 88899513, 88899526, 13, 1920x1080 
0x2514ABF8, 37404069258045992, 88899559, 88899582, 23, 1920x1080 
0x2514ABF8, 37404069258480160, 88899600, 88899614, 14, 1920x1080 
0x2514ABF8, 37404069258873648, 88899645, 88899666, 21, 1920x1080 
0x2514ABF8, 37404069259330184, 88899681, 88899696, 15, 1920x1080 
0x2514ABF8, 37404069259696424, 88899729, 88899749, 20, 1920x1080 
0x2514ABF8, 37404069260153992, 88899763, 88899779, 16, 1920x1080 
0x2514ABF8, 37404069260520512, 88899807, 88899822, 15, 1920x1080 
0x2514ABF8, 37404069260986024, 88899846, 88899862, 16, 1920x1080 
0x2514ABF8, 37404069261360128, 88899890, 88899904, 14, 1920x1080 
0x2514ABF8, 37404069261821104, 88899934, 88899949, 15, 1920x1080 
0x2514ABF8, 37404069262213448, 88899974, 88899988, 14, 1920x1080 
0x2514ABF8, 37404069262659464, 88900013, 88900026, 13, 1920x1080 
0x2514ABF8, 37404069263035064, 88900059, 88900073, 14, 1920x1080 
0x2514ABF8, 37404069263488448, 88900098, 88900111, 13, 1920x1080 
0x2514ABF8, 37404069263891192, 88900142, 88900165, 23, 1920x1080 
0x2514ABF8, 37404069264327848, 88900181, 88900201, 20, 1920x1080 
0x2514ABF8, 37404069264682496, 88900213, 88900233, 20, 1920x1080 
0x2514ABF8, 37404069265011144, 88900246, 88900259, 13, 1920x1080 
0x2514ABF8, 37404069265368024, 88900293, 88900316, 23, 1920x1080 
0x2514ABF8, 37404069265814584, 88900331, 88900347, 16, 1920x1080 
0x2514ABF8, 37404069266201432, 88900378, 88900399, 21, 1920x1080 
0x2514ABF8, 37404069266656856, 88900411, 88900424, 13, 1920x1080 
0x2514ABF8, 37404069267016240, 88900449, 88900463, 14, 1920x1080 
0x2514ABF8, 37404069267397400, 88900494, 88900515, 21, 1920x1080 
0x2514ABF8, 37404069267826000, 88900528, 88900550, 22, 1920x1080 
0x2514ABF8, 37404069268183352, 88900561, 88900573, 12, 1920x1080 
0x2514ABF8, 37404069268531088, 88900612, 88900632, 20, 1920x1080 
0x2514ABF8, 37404069268984000, 88900645, 88900658, 13, 1920x1080 
0x2514ABF8, 37404069269373024, 88900694, 88900716, 22, 1920x1080 
0x2514ABF8, 37404069269826560, 88900727, 88900739, 12, 1920x1080 
0x2514ABF8, 37404069270192984, 88900777, 88900799, 22, 1920x1080 
0x2514ABF8, 37404069270657160, 88900816, 88900830, 14, 1920x1080 
0x2514ABF8, 37404069271041928, 88900856, 88900871, 15, 1920x1080 
0x2514ABF8, 37404069271489816, 88900895, 88900908, 13, 1920x1080 
0x2514ABF8, 37404069271869624, 88900941, 88900955, 14, 1920x1080 
0x2514ABF8, 37404069272315416, 88900981, 88900997, 16, 1920x1080 
0x2514ABF8, 37404069272703272, 88901026, 88901049, 23, 1920x1080 
0x2514ABF8, 37404069273159664, 88901061, 88901083, 22, 1920x1080 
0x2514ABF8, 37404069273509776, 88901095, 88901109, 14, 1920x1080 
0x2514ABF8, 37404069273870392, 88901141, 88901155, 14, 1920x1080 
0x2514ABF8, 37404069274328896, 88901183, 88901202, 19, 1920x1080 
0x2514ABF8, 37404069274713160, 88901229, 88901252, 23, 1920x1080 
0x2514ABF8, 37404069275182160, 88901267, 88901281, 14, 1920x1080 
0x2514ABF8, 37404069275554184, 88901306, 88901319, 13, 1920x1080 
0x2514ABF8, 37404069275985680, 88901350, 88901364, 14, 1920x1080 
0x2514ABF8, 37404069276380952, 88901395, 88901416, 21, 1920x1080 
0x2514ABF8, 37404069276841040, 88901429, 88901444, 15, 1920x1080 
0x2514ABF8, 37404069277191200, 88901479, 88901501, 22, 1920x1080 
0x2514ABF8, 37404069277661040, 88901518, 88901534, 16, 1920x1080 
0x2514ABF8, 37404069278046048, 88901563, 88901582, 19, 1920x1080 
0x2514ABF8, 37404069278514896, 88901595, 88901609, 14, 1920x1080 
0x2514ABF8, 37404069278866840, 88901641, 88901654, 13, 1920x1080 
0x2514ABF8, 37404069279320456, 88901685, 88901699, 14, 1920x1080 
0x2514ABF8, 37404069279733944, 88901730, 88901751, 21, 1920x1080 
0x2514ABF8, 37404069280174192, 88901764, 88901778, 14, 1920x1080 
0x2514ABF8, 37404069280551456, 88901808, 88901821, 13, 1920x1080 
0x2514ABF8, 37404069280993368, 88901847, 88901864, 17, 1920x1080 
0x2514ABF8, 37404069281365688, 88901896, 88901909, 13, 1920x1080 
0x2514ABF8, 37404069281990304, 88901945, 88901959, 14, 1920x1080 
0x2514ABF8, 37404069282487520, 88901996, 88902009, 13, 1920x1080 
0x2514ABF8, 37404069282873480, 88902048, 88902062, 14, 1920x1080 
0x2514ABF8, 37404069283404400, 88902096, 88902109, 13, 1920x1080 
0x2514ABF8, 37404069283885536, 88902148, 88902162, 14, 1920x1080 
0x2514ABF8, 37404069284377064, 88902197, 88902210, 13, 1920x1080 
0x2514ABF8, 37404069284866320, 88902246, 88902265, 19, 1920x1080 
0x2514ABF8, 37404069285349176, 88902281, 88902294, 13, 1920x1080 
0x2514ABF8, 37404069285719144, 88902326, 88902340, 14, 1920x1080 
0x2514ABF8, 37404069286169504, 88902366, 88902383, 17, 1920x1080 
0x2514ABF8, 37404069286549120, 88902410, 88902424, 14, 1920x1080 
0x2514ABF8, 37404069287012040, 88902450, 88902466, 16, 1920x1080 
0x2514ABF8, 37404069287404888, 88902495, 88902518, 23, 1920x1080 
0x2514ABF8, 37404069287845720, 88902534, 88902550, 16, 1920x1080 
0x2514ABF8, 37404069288221056, 88902580, 88902594, 14, 1920x1080 
0x2514ABF8, 37404069288702136, 88902625, 88902645, 20, 1920x1080 
0x2514ABF8, 37404069289163128, 88902664, 88902680, 16, 1920x1080 
0x2514ABF8, 37404069289533752, 88902709, 88902721, 12, 1920x1080 
0x2514ABF8, 37404069290139184, 88902762, 88902775, 13, 1920x1080 
0x2514ABF8, 37404069290734512, 88902831, 88902844, 13, 1920x1080 
0x2514ABF8, 37404069291354640, 88902898, 88902915, 17, 1920x1080 
0x2514ABF8, 37404069291876384, 88902944, 88902958, 14, 1920x1080 
0x2514ABF8, 37404069292349808, 88902990, 88903004, 14, 1920x1080 
0x2514ABF8, 37404069292833680, 88903031, 88903045, 14, 1920x1080 
0x2514ABF8, 37404069293210392, 88903075, 88903090, 15, 1920x1080 
0x2514ABF8, 37404069293676864, 88903115, 88903131, 16, 1920x1080 
0x2514ABF8, 37404069294049752, 88903161, 88903187, 26, 1920x1080 
0x2514ABF8, 37404069294507888, 88903205, 88903221, 16, 1920x1080 
0x2514ABF8, 37404069294931008, 88903250, 88903267, 17, 1920x1080 
0x2514ABF8, 37404069295378104, 88903294, 88903316, 22, 1920x1080 
0x2514ABF8, 37404069295840400, 88903332, 88903346, 14, 1920x1080 
0x2514ABF8, 37404069296213232, 88903377, 88903396, 19, 1920x1080 
0x2514ABF8, 37404069296673840, 88903416, 88903435, 19, 1920x1080 
0x2514ABF8, 37404069297049152, 88903461, 88903474, 13, 1920x1080 
0x2514ABF8, 37404069297533560, 88903511, 88903534, 23, 1920x1080 
0x2514ABF8, 37404069298004832, 88903544, 88903558, 14, 1920x1080 
0x2514ABF8, 37404069298353328, 88903593, 88903618, 25, 1920x1080 
0x2514ABF8, 37404069298825896, 88903632, 88903644, 12, 1920x1080 
0x2514ABF8, 37404069299216320, 88903676, 88903691, 15, 1920x1080 
0x2514ABF8, 37404069299658144, 88903715, 88903728, 13, 1920x1080 
0x2514ABF8, 37404069300070136, 88903760, 88903784, 24, 1920x1080 
0x2514ABF8, 37404069300501088, 88903798, 88903811, 13, 1920x1080 
0x2514ABF8, 37404069300886568, 88903842, 88903856, 14, 1920x1080 
0x2514ABF8, 37404069301332848, 88903880, 88903893, 13, 1920x1080 
0x2514ABF8, 37404069301710112, 88903928, 88903952, 24, 1920x1080 
0x2514ABF8, 37404069302169888, 88903966, 88903982, 16, 1920x1080 
0x2514ABF8, 37404069302547208, 88904011, 88904032, 21, 1920x1080 
0x2514ABF8, 37404069303013424, 88904045, 88904058, 13, 1920x1080 
0x2514ABF8, 37404069303368120, 88904090, 88904105, 15, 1920x1080 
0x2514ABF8, 37404069304263040, 88904210, 88904217, 7, 1280x720 
0x2514ABF8, 37404069304704360, 88904244, 88904256, 12, 1280x720 
0x2514ABF8, 37404069305216952, 88904288, 88904298, 10, 1280x720 
0x2514ABF8, 37404069305680616, 88904326, 88904334, 8, 1280x720 
0x2514ABF8, 37404069306049816, 88904371, 88904378, 7, 1280x720 
0x2514ABF8, 37404069306519192, 88904421, 88904434, 13, 1280x720 
0x2514ABF8, 37404069306987744, 88904456, 88904463, 7, 1280x720 
0x2514ABF8, 37404069307372848, 88904506, 88904515, 9, 1280x720 
0x2514ABF8, 37404069307833160, 88904539, 88904546, 7, 1280x720 
0x2514ABF8, 37404069308193216, 88904585, 88904598, 13, 1280x720 
0x2514ABF8, 37404069308651336, 88904622, 88904628, 6, 1280x720 
0x2514ABF8, 37404069309034736, 88904671, 88904681, 10, 1280x720 
0x2514ABF8, 37404069309485136, 88904709, 88904722, 13, 1280x720 
0x2514ABF8, 37404069309891520, 88904753, 88904764, 11, 1280x720 
0x2514ABF8, 37404069310325232, 88904791, 88904797, 6, 1280x720 
0x2514ABF8, 37404069310716424, 88904835, 88904848, 13, 1280x720 
0x2514ABF8, 37404069311161448, 88904872, 88904878, 6, 1280x720 
0x2514ABF8, 37404069311543800, 88904917, 88904931, 14, 1280x720 
0x2514ABF8, 37404069311989408, 88904956, 88904963, 7, 1280x720 
0x2514ABF8, 37404069312365976, 88905005, 88905017, 12, 1280x720 
0x2514ABF8, 37404069312841368, 88905039, 88905046, 7, 1280x720 
0x2514ABF8, 37404069313206200, 88905088, 88905099, 11, 1280x720 
0x2514ABF8, 37404069313665024, 88905121, 88905127, 6, 1280x720 
0x2514ABF8, 37404069314037440, 88905168, 88905183, 15, 1280x720 
0x2514ABF8, 37404069314489952, 88905205, 88905211, 6, 1280x720 
0x2514ABF8, 37404069314882000, 88905250, 88905261, 11, 1280x720 
0x2514ABF8, 37404069315325624, 88905291, 88905303, 12, 1280x720 
0x2514ABF8, 37404069315674504, 88905326, 88905342, 16, 1280x720 
0x2514ABF8, 37404069316056584, 88905375, 88905381, 6, 1280x720 
0x2514ABF8, 37404069316497760, 88905408, 88905416, 8, 1280x720 
0x2514ABF8, 37404069316882416, 88905454, 88905466, 12, 1280x720 
0x2514ABF8, 37404069317333176, 88905491, 88905499, 8, 1280x720 
0x2514ABF8, 37404069317705680, 88905537, 88905546, 9, 1280x720 
0x2514ABF8, 37404069318152536, 88905574, 88905582, 8, 1280x720 
0x2514ABF8, 37404069318532416, 88905623, 88905630, 7, 1280x720 
0x2514ABF8, 37404069318989432, 88905659, 88905667, 8, 1280x720 
0x2514ABF8, 37404069319381296, 88905704, 88905713, 9, 1280x720 
0x2514ABF8, 37404069319819184, 88905742, 88905750, 8, 1280x720 
0x2514ABF8, 37404069320211784, 88905785, 88905798, 13, 1280x720 
0x2514ABF8, 37404069320659152, 88905823, 88905831, 8, 1280x720 
0x2514ABF8, 37404069321029600, 88905867, 88905880, 13, 1280x720 
0x2514ABF8, 37404069321486824, 88905907, 88905915, 8, 1280x720 
0x2514ABF8, 37404069321860592, 88905952, 88905963, 11, 1280x720 
0x2514ABF8, 37404069322336424, 88905987, 88905996, 9, 1280x720 
0x2514ABF8, 37404069322696784, 88906037, 88906046, 9, 1280x720 
0x2514ABF8, 37404069323144184, 88906071, 88906079, 8, 1280x720 
0x2514ABF8, 37404069323529112, 88906117, 88906130, 13, 1280x720 
0x2514ABF8, 37404069323983712, 88906155, 88906163, 8, 1280x720 
0x2514ABF8, 37404069324362296, 88906205, 88906213, 8, 1280x720 
0x2514ABF8, 37404069324820632, 88906239, 88906247, 8, 1280x720 
0x2514ABF8, 37404069325210312, 88906285, 88906297, 12, 1280x720 
0x2514ABF8, 37404069325664704, 88906323, 88906333, 10, 1280x720 
0x2514ABF8, 37404069326053584, 88906374, 88906380, 6, 1280x720 
0x2514ABF8, 37404069326520640, 88906419, 88906434, 15, 1280x720 
0x2514ABF8, 37404069327000784, 88906459, 88906466, 7, 1280x720 
0x2514ABF8, 37404069327390024, 88906504, 88906518, 14, 1280x720 
0x2514ABF8, 37404069327836384, 88906542, 88906549, 7, 1280x720 
0x2514ABF8, 37404069328220104, 88906587, 88906599, 12, 1280x720 
0x2514ABF8, 37404069328663896, 88906626, 88906633, 7, 1280x720 
0x2514ABF8, 37404069329036520, 88906672, 88906684, 12, 1280x720 
0x2514ABF8, 37404069329506032, 88906712, 88906725, 13, 1280x720 
0x2514ABF8, 37404069329886104, 88906753, 88906766, 13, 1280x720 
0x2514ABF8, 37404069330329192, 88906790, 88906796, 6, 1280x720 
0x2514ABF8, 37404069330698416, 88906834, 88906847, 13, 1280x720 
0x2514ABF8, 37404069331153760, 88906873, 88906879, 6, 1280x720 
0x2514ABF8, 37404069331543128, 88906919, 88906929, 10, 1280x720 
0x2514ABF8, 37404069331981184, 88906952, 88906960, 8, 1280x720 
0x2514ABF8, 37404069332355920, 88907004, 88907014, 10, 1280x720 
0x2514ABF8, 37404069332813256, 88907039, 88907046, 7, 1280x720 
0x2514ABF8, 37404069333203840, 88907084, 88907098, 14, 1280x720 
0x2514ABF8, 37404069333660096, 88907121, 88907127, 6, 1280x720 
0x2514ABF8, 37404069334023736, 88907172, 88907181, 9, 1280x720 
0x2514ABF8, 37404069334492152, 88907210, 88907222, 12, 1280x720 
0x2514ABF8, 37404069334875616, 88907256, 88907264, 8, 1280x720 
0x2514ABF8, 37404069335324344, 88907289, 88907295, 6, 1280x720 
0x2514ABF8, 37404069335707640, 88907334, 88907347, 13, 1280x720 
0x2514ABF8, 37404069336155216, 88907374, 88907380, 6, 1280x720 
0x2514ABF8, 37404069336547048, 88907424, 88907433, 9, 1280x720 
0x2514ABF8, 37404069337009784, 88907457, 88907463, 6, 1280x720 
0x2514ABF8, 37404069337360600, 88907507, 88907516, 9, 1280x720 
0x2514ABF8, 37404069337865168, 88907553, 88907564, 11, 1280x720 
0x2514ABF8, 37404069338335448, 88907593, 88907607, 14, 1280x720 
0x2514ABF8, 37404069338702576, 88907639, 88907647, 8, 1280x720 
0x2514ABF8, 37404069339159032, 88907672, 88907681, 9, 1280x720 
0x2514ABF8, 37404069339554000, 88907722, 88907731, 9, 1280x720 
0x2514ABF8, 37404069339993056, 88907755, 88907763, 8, 1280x720 
0x2514ABF8, 37404069340356312, 88907806, 88907813, 7, 1280x720 
0x2514ABF8, 37404069340824592, 88907839, 88907847, 8, 1280x720 
